111111111111111111111
1P000000000C0000000E1
111011101110111011111
1C1000001000001C100C1
1C1011101110111011101
101C10001C101C100E1C1
101C101111001C1011101
1C1010C000101010000101
101010111111010101111
100010100010000010001
100000100000001000001
111111111111111111111
