1111111111111
1E0000000C0C1
111001111C001
1P00110000001
1111111111111
