11111111111111111111111111
10001000000001000100001001
1100000111000C000C00001001
11100011000101111111000001
10000111001001E00111000111
111000010011111C1100000001
100000000000010C0111110001
1P000010000001000C00000101
11111111111111111111111111
